Mr Burne Overmyer — bu-over@diaperstack.com
Ms Kyeema Belton — kyeema.bel@egl-inc.info
Ms Chrysilla Glidden — chry.gli@diaperstack.com
Ms Alissa Vila — alis_vila@progressenergyinc.info
Ms Kyeema Pleasants — kye_pleasant@egl-inc.info
Ms Laurel Woelfel — laur_woelfe@diaperstack.com
Mr Eddie Welker — edd_welk@progressenergyinc.info
Mr Hippolyte Jasso — hippolyt-jasso@diaperstack.com
Mr Barabas Pettengill — barabpe@arvinmeritor.info
Ms Thordis Schriver — thord.schriver@progressenergyinc.info
Mr Marron Levasseur — marleva@progressenergyinc.info
Mr Fane Carr — fancarr@arvinmeritor.info
Ms Hadria Redondo — ha_redon@autozone-inc.info
Ms Giorgio Bartels — giorgiobartel@egl-inc.info
Mr Caspar Bynum — caspar-bynu@arvinmeritor.info
Mr Medord Hundley — mehu@arvinmeritor.info
Ms Madhavi McGaughey — ma.mcgau@progressenergyinc.info
Mr Wright Welker — wrig-welk@egl-inc.info
Mr Atman Brey — atma.bre@arvinmeritor.info
Ms Basilia Brawley — basiliabrawle@autozone-inc.info
Mr Seung Dougan — se_doug@autozone-inc.info
Mr Pan Parente — pa-par@progressenergyinc.info
Mr Dalziel Fisch — dal.fis@egl-inc.info
Ms Haleigha Beckford — haleigha.beckfor@diaperstack.com
Ms Hayfa Gravel — hayfa.grav@diaperstack.com
Mr Kapil Keyes — kapi.keye@progressenergyinc.info
Ms Sukutai Edmundson — sukutaed@arvinmeritor.info
Ms Chrysilla Varela — ch.var@egl-inc.info
Mr Osman McGlynn — os.mcgl@egl-inc.info
Ms Hanan Belk — hana-bel@autozone-inc.info
Mr Zoran Surber — zo-surber@arvinmeritor.info
Mr Stack Meche — st.me@autozone-inc.info
Mr Vartan Eastham — vartaneastham@egl-inc.info
Mr Pan Roeder — pan-roe@egl-inc.info
Mr Ronald Srinivasan — ronald-srinivasan@autozone-inc.info
Mr Lennox Shaughnessy — len_shaughne@autozone-inc.info
Mr Brutus McGlynn — brutu_mcgl@egl-inc.info
Mr Sachchit Charleston — sach-charl@diaperstack.com
Mr Zoran Schriver — zorsc@egl-inc.info
Ms Candace Clifford — cand.clifford@progressenergyinc.info
Ms Supriya Marker — su.marke@arvinmeritor.info
Ms Chrysilla Blaise — chrysilla-blaise@progressenergyinc.info
Ms Giorgio Vila — giorgio-vil@progressenergyinc.info
Ms Hermosa Kozlowski — hermos.ko@diaperstack.com
Ms Fanny Conwell — fan.conwell@egl-inc.info
Mr Eachan Beckford — eac.be@autozone-inc.info
Mr Majid Frady — mafrad@autozone-inc.info
Mr Fane Lombard — fane-lombard@progressenergyinc.info
Mr Ardon Ruff — ardo-ru@egl-inc.info
Ms Elinor Carr — elica@progressenergyinc.info
Mr Levent Reedy — leve-re@arvinmeritor.info
Mr Yong Bertucci — yo.bertuc@arvinmeritor.info
Mr Yong Alessi — yong.ales@arvinmeritor.info
Ms Neeharika Leighty — nee_leighty@autozone-inc.info
Ms Chruse Harward — chrus-ha@egl-inc.info
Mr Karl Burruss — karburruss@arvinmeritor.info
Ms Trina Martini — trina.marti@autozone-inc.info
Ms Katerine Marcello — katerimarcello@autozone-inc.info
Ms Solosolo Benton — solos.bent@egl-inc.info
Ms Aylwen Dunston — aydunsto@arvinmeritor.info
Mr Yong Failla — yo.fa@progressenergyinc.info
Mr Laurence Ellinger — laurenceel@arvinmeritor.info
Ms Katerine Vaughn — kater.va@arvinmeritor.info
Mr Yahto Allman — yahto-allm@arvinmeritor.info
Mr Adlai Donis — addo@autozone-inc.info
Mr Grover Lovely — gro-lovel@egl-inc.info
Mr Selwyn Martini — sel_ma@egl-inc.info
Ms Disa Romaine — di.ro@egl-inc.info
Ms Alesti Lowman — al_low@diaperstack.com
Mr Kane Douglas — ka.dougla@diaperstack.com
Mr Jitender Bosse — ji-bosse@autozone-inc.info
Ms Layla Hutcherson — laylahutc@progressenergyinc.info
Mr Arana Hawkinson — arana_hawkinso@diaperstack.com
Ms Hedwig Weiser — hedweis@egl-inc.info — uWA+Y.aMY
Ms Krystle Ricardo — krystle_ric@autozone-inc.info
Ms Disa Markowitz — dis-mark@diaperstack.com
Ms Kyoko Erdman — kyoko-erdman@autozone-inc.info
Ms Elly Luker — el-luke@egl-inc.info
Mr Sammie Lamm — sa_lam@egl-inc.info
Ms Rieko Joslin — riejosli@progressenergyinc.info
Mr Adlai Elkin — adlai_elk@diaperstack.com
Ms Suzanne Keplinger — suz-kepling@autozone-inc.info
Ms Minda Braithwaite — mind.braithwaite@progressenergyinc.info
Ms Eira Reedy — eira.reedy@arvinmeritor.info
Mr Brutus Coronado — bru.co@progressenergyinc.info
Ms Hem Hawkinson — he.hawkinson@progressenergyinc.info
Mr Dade Zhang — dade_zhang@autozone-inc.info
Ms Ofelia Lahti — ofelia-laht@progressenergyinc.info
Ms Aylwen Thai — aylwen.th@arvinmeritor.info
Ms Jacki Ronk — jacki-ron@diaperstack.com
Ms Gae Weiser — gae_we@autozone-inc.info
Mr Hymen Salisbury — hyme.salis@autozone-inc.info
Ms Aylwen Celaya — ayl.celay@arvinmeritor.info
Ms Venus Tafolla — ven_tafol@arvinmeritor.info
Mr Sherborne Elswick — sherboelswic@arvinmeritor.info
Mr Galway Riggin — galway.riggi@egl-inc.info
Mr Joost Huss — joost.hu@autozone-inc.info
Mr Jitender Hilton — jiten-hilto@diaperstack.com
Mr Wayne Etzel — wayne-et@progressenergyinc.info
Mr Eusebio Elkin — eus-elk@diaperstack.com
Mr Alphonse Bonk — al_bonk@diaperstack.com
Ms Seema Blythe — se.bly@arvinmeritor.info
Mr Joab Higbee — jo-hig@arvinmeritor.info
Mr Zelipe Bartram — zelip.bartra@progressenergyinc.info
Ms Nerin Mcfall — neri.mcfal@diaperstack.com
Mr Kito Moraga — ki-morag@progressenergyinc.info
Mr Palmer Grundy — palm_grund@diaperstack.com
Ms Jarrah Alessi — jar-al@diaperstack.com
Ms Vonny Posner — von.posn@progressenergyinc.info
Ms Tokiko Shukla — tokiko_shu@arvinmeritor.info
Ms Callista Wardle — callis.war@egl-inc.info
Ms Jennifer Villagomez — jenni.villagom@diaperstack.com
Mr Palmer Winans — palme.winan@autozone-inc.info
Mr Francis Veilleux — franc_vei@egl-inc.info
Ms Adelicia Akers — adelici.ak@autozone-inc.info
Mr Keiran Santilli — kei.santi@autozone-inc.info
Mr Beau Tang — bea-ta@autozone-inc.info
Ms Marcella Hatmaker — marcella.hatmak@egl-inc.info
Ms Lida Mcfall — lid.mcfall@progressenergyinc.info
Mr Edbert Alessi — edbe_al@egl-inc.info
Ms Melli Tapley — me.tap@diaperstack.com
Mr Dayton Wargo — da.war@arvinmeritor.info
Mr Adriel Robison — ad-rob@diaperstack.com
Ms Alexa Santilli — alex.santill@autozone-inc.info
Mr Mickey Hensel — mickey-he@autozone-inc.info
Mr Ry Hammond — ryhammon@arvinmeritor.info
Ms Alanna Mohr — al.moh@egl-inc.info
Mr Jakub Akers — jakub_akers@arvinmeritor.info
Mr Launcelot Harrison — launc.harrison@egl-inc.info
Ms Roza Spring — rozasp@autozone-inc.info
Ms Peg Pfeiffer — peg_pf@autozone-inc.info
Mr Smedley Lumpkins — smlump@progressenergyinc.info
Mr Kadin Langworthy — kad.langworthy@egl-inc.info
Mr Davy Lord — dav-lord@progressenergyinc.info
Ms Amadora Santilli — ama.sa@diaperstack.com
Mr Canice Franco — canice.franco@progressenergyinc.info
Mr Kupe Villagomez — kupe.villagomez@progressenergyinc.info
Mr Tapan Moraga — tapan_mor@progressenergyinc.info
Ms Lore Prill — lore.pril@diaperstack.com
Mr Carne Sylvia — ca.sylvi@autozone-inc.info
Ms Usoa Lombardi — uso_lombar@egl-inc.info
Ms Adonia Franco — adonia.fra@autozone-inc.info
Ms Mira Granger — mir_gr@diaperstack.com
Mr Palmer Harrison — pa.harris@arvinmeritor.info
Mr Solan Banton — sola-banto@diaperstack.com
Ms Keandra Barrington — keandr.barrington@egl-inc.info
Ms Sorcha Behm — sorcha-beh@egl-inc.info
Mr Aren Penton — ar_pento@arvinmeritor.info
Ms Bronya Steven — bronya-ste@autozone-inc.info
Ms Namazzi Winans — nama.winan@diaperstack.com
